58
14
43 0 0 0 0 0 0 0 0 0 0 0 0 0 0 0 0 0 0 0 0 0 0 0 0 0 0 0 0 0 0 40 33 33 33 33 33 33 33 33 33 33 33 33 33 33 33 33 33 33 33 33 33 33 33 33 33 33 
43 0 0 0 0 0 0 0 0 0 0 0 0 0 0 0 0 0 0 0 0 0 0 0 0 0 0 0 0 0 0 0 40 33 33 33 33 33 33 33 33 33 33 33 33 33 33 33 33 32 41 0 0 53 0 0 40 33 
43 0 0 0 0 0 0 0 0 0 0 0 0 0 0 0 0 0 0 0 0 0 0 0 0 0 0 0 0 0 0 0 0 40 33 33 33 33 33 33 33 33 33 33 33 33 33 33 41 0 0 0 0 0 0 0 0 36 
43 0 0 0 0 0 0 0 0 0 0 0 0 0 0 0 0 0 0 0 0 0 0 0 0 0 0 0 0 0 0 0 0 0 33 33 33 33 33 33 32 33 33 33 33 33 33 41 0 0 0 0 0 0 0 0 0 42 
43 0 0 0 0 0 0 0 0 0 0 0 0 0 0 0 0 0 0 0 0 0 0 0 0 0 0 0 0 0 0 0 0 0 33 33 33 33 41 53 0 40 33 33 33 33 41 0 0 0 0 0 0 0 0 0 0 42 
43 0 0 0 0 0 0 0 0 0 0 0 0 0 0 0 0 0 0 0 0 0 0 0 0 0 0 0 0 0 0 0 0 0 33 33 33 54 0 0 0 0 40 33 33 33 0 0 0 0 0 0 0 0 0 0 0 42 
43 0 0 0 0 0 0 0 0 0 0 0 0 0 0 0 0 0 0 0 0 0 0 0 0 0 0 0 0 8 0 0 0 0 40 32 41 0 0 0 0 0 0 40 32 41 0 0 0 0 0 0 0 0 0 0 0 42 
43 0 0 0 0 0 0 0 0 0 0 0 0 0 0 0 0 20 0 0 0 20 0 0 0 20 0 0 0 20 0 0 0 0 0 0 0 0 0 0 0 0 0 0 0 0 0 0 0 0 0 0 0 0 0 0 0 42 
43 0 0 0 0 0 0 0 0 0 0 0 0 10 0 0 0 0 0 0 0 0 0 0 0 0 0 0 0 0 0 0 12 0 0 0 0 0 0 0 0 0 0 0 0 0 0 0 0 0 0 0 0 0 0 0 0 42 
43 0 0 0 0 0 0 0 0 0 0 0 47 46 0 0 0 0 0 0 0 0 0 0 0 0 0 0 0 0 0 0 0 0 0 0 0 0 0 0 0 0 0 0 0 0 0 0 0 0 0 0 0 0 0 0 0 42 
43 0 0 0 0 0 0 0 0 0 0 0 42 43 0 0 0 6 0 0 0 0 0 0 0 0 0 0 0 0 0 50 50 0 0 0 0 0 0 0 0 0 0 0 0 0 0 0 2 0 0 0 0 0 0 0 0 42 
43 0 0 0 0 0 0 0 0 0 0 0 42 44 22 22 22 22 22 26 0 0 16 0 0 0 16 0 0 40 39 39 39 39 39 51 51 51 39 51 51 51 39 55 55 55 55 30 46 0 0 0 0 0 0 0 0 42 
43 0 0 0 5 0 0 0 0 0 9 0 42 32 32 32 32 32 41 0 0 0 0 0 0 0 0 0 0 0 40 32 32 32 33 33 33 33 33 33 33 33 33 56 56 56 56 33 43 0 0 0 0 0 0 0 0 42 
44 22 22 22 22 22 22 22 22 22 22 22 45 48 48 48 48 48 48 48 48 48 48 48 48 48 48 48 48 48 48 48 48 48 33 33 33 33 33 33 33 33 33 56 56 56 56 33 30 22 22 22 22 22 22 22 22 45 
